1111111
1110011
1100C11
1000001
1P000E1
1000001
1111111
1111111